2111111111111111111111112
1000000000000000000000001
1000000000000000000000001
1000000000000000000000001
1000000000000000000000001
1000000000000000000000001
1000000000000000000000001
1000000111111111112000001
1000000000000000001000001
1000000000000000001000001
1000000000000000001000001
1000000000000000000000001
1000000000000000000000001
1000000000000000000000001
1000000000000000000000001
1000001000000000000000001
1000001000000000000000001
1000001000000000000000001
1000002111111111110000001
1000000000000000000000001
1000000000000000000000001
1000000000000000000000001
1000000000000000000000001
1000000000000000000000001
2111111111111111111111112